18 18 18 18 18 18 18 18 18 18 18 18 18 18 18 18 18 18 18 18 18 18 18 18 18 18 18 18 18 18 18 18 18 18 18 18 18 18 18 18 18 18 18 18 18 18 18 18 18 18 
18 18 18 18 18 18 18 18 18 18 18 18 18 18 18 18 23 22 22 22 22 22 22 22 22 22 22 22 22 22 24 1 1 1 18 18 18 18 18 18 18 18 18 18 18 18 18 18 18 18 
18 18 18 18 18 18 18 18 18 18 18 18 18 18 18 18 25 21 21 21 21 21 21 21 21 21 21 21 21 21 34 24 1 1 18 18 18 18 18 18 18 18 18 18 18 18 18 18 18 18 
18 18 18 18 18 18 18 18 18 18 18 18 18 18 18 18 25 21 21 21 21 21 21 21 21 21 21 21 21 21 21 26 1 1 18 18 18 18 18 18 18 18 18 18 18 18 18 18 18 18 
18 18 18 18 18 18 18 18 18 18 18 18 18 18 18 18 25 21 21 21 21 21 21 21 21 21 21 21 21 21 21 26 1 1 18 18 18 18 18 18 18 18 18 18 18 18 18 18 18 18 
18 18 18 18 18 18 18 18 18 18 18 18 18 18 18 18 25 21 21 21 21 32 29 29 29 31 21 21 21 21 21 26 1 1 1 1 1 1 1 1 1 1 1 18 18 18 18 18 18 18 
18 18 18 18 18 18 18 19 19 19 19 19 19 19 18 18 25 21 20 21 21 26 13 10 12 25 21 32 29 31 21 26 1 1 1 1 1 1 1 13 10 12 1 18 18 18 18 18 18 18 
18 18 18 18 18 18 18 19 0 0 0 0 0 19 18 18 25 21 21 20 21 26 7 16 6 25 32 27 1 28 31 26 1 1 1 1 1 1 1 7 2 6 1 1 1 1 18 18 18 18 
18 18 18 18 18 18 18 19 0 0 0 0 0 19 18 18 25 20 21 20 21 26 7 17 6 25 26 1 18 1 25 26 1 1 1 1 1 1 1 14 3 15 1 1 1 1 18 18 18 18 
18 18 18 18 18 18 18 19 0 0 0 0 0 19 18 18 25 21 21 21 21 26 7 17 6 25 34 24 1 23 33 26 1 1 18 18 18 18 18 18 18 18 18 18 18 1 18 18 18 18 
18 18 18 18 18 18 18 19 0 0 0 0 0 19 18 18 25 21 21 21 21 26 7 2 6 25 21 34 22 33 32 27 1 1 18 18 18 18 18 18 18 18 18 18 18 1 18 18 18 18 
18 18 18 18 18 18 18 19 19 19 2 19 19 19 18 18 28 29 29 29 29 27 7 2 6 28 29 29 29 29 27 1 1 1 18 18 18 18 18 18 18 18 18 18 18 1 18 18 18 18 
18 18 18 18 18 18 18 18 18 18 1 18 18 18 18 18 18 18 18 18 18 18 7 2 6 18 18 18 18 18 18 1 1 18 18 18 18 18 1 1 1 1 1 1 1 1 18 18 18 18 
18 18 18 18 18 18 18 18 18 18 1 18 18 18 18 18 18 18 18 18 18 18 7 2 6 18 18 18 18 18 18 18 18 18 18 18 18 1 1 1 1 1 1 1 1 1 18 18 18 18 
18 18 18 18 18 18 18 18 18 18 1 18 18 18 18 18 18 18 18 18 18 18 7 2 6 18 18 18 18 18 18 18 18 18 18 18 18 13 10 12 18 18 18 18 18 18 18 18 18 18 
18 18 18 18 18 18 18 18 18 18 1 18 18 18 18 18 18 18 18 18 18 18 7 2 6 18 18 18 18 18 18 18 18 18 18 18 18 7 2 6 18 18 18 18 18 18 18 18 18 18 
18 18 18 18 18 18 18 18 18 1 1 18 18 18 18 18 18 18 18 18 18 18 7 2 9 10 10 10 10 12 18 18 18 18 18 18 18 7 2 6 18 18 18 18 18 18 18 18 18 18 
18 18 18 18 18 18 18 18 1 1 18 18 18 18 18 18 18 18 18 18 18 18 7 2 2 2 2 2 2 6 18 18 18 18 18 18 18 7 2 6 18 18 18 18 18 18 18 18 18 18 
18 18 18 18 18 18 18 1 1 18 18 18 18 18 18 18 18 18 18 18 18 18 7 2 4 3 3 3 3 15 18 18 18 18 18 18 18 7 2 6 18 18 18 18 18 18 18 18 18 18 
18 18 18 18 18 18 1 1 1 18 18 18 18 18 18 18 18 18 18 18 18 18 7 17 6 18 18 18 18 18 18 18 18 18 18 18 13 8 2 6 18 18 18 18 18 18 18 18 18 18 
18 18 18 18 18 1 1 1 18 18 18 18 18 18 18 13 10 10 10 10 10 10 8 17 9 10 10 10 10 10 10 10 10 10 10 10 8 2 4 15 18 18 18 18 18 18 18 18 18 18 
18 18 18 18 18 1 1 18 18 18 18 18 18 18 1 7 2 2 2 2 17 17 17 17 17 17 17 2 2 2 2 2 2 2 2 2 2 2 6 18 18 18 18 18 18 18 18 18 18 18 
18 18 18 18 18 1 1 18 18 18 18 1 2 1 1 14 3 3 3 3 3 3 5 17 4 3 3 3 3 3 3 3 3 3 3 3 5 2 6 18 18 18 18 18 18 18 18 18 18 18 
18 18 18 18 1 1 1 18 18 18 18 1 18 18 1 1 1 18 18 18 18 18 7 17 6 18 18 18 18 18 18 18 18 18 18 18 7 2 6 18 18 18 18 18 18 18 18 18 18 18 
18 18 18 18 1 1 18 18 18 18 1 1 1 18 18 18 18 18 18 18 18 18 7 2 6 18 18 18 18 18 18 18 18 18 18 18 7 2 6 18 18 18 18 18 18 18 18 18 18 18 
18 18 18 18 1 18 18 18 18 18 1 1 1 18 18 18 18 18 18 18 18 18 7 2 6 18 18 18 18 18 18 18 18 18 18 18 7 2 6 18 18 18 18 18 18 18 18 18 18 18 
18 18 18 18 1 18 18 18 18 18 1 1 1 18 18 18 18 18 18 18 18 18 7 2 6 18 18 18 18 18 18 18 18 18 18 18 14 3 15 1 18 18 18 18 18 18 18 18 18 18 
18 18 18 18 1 18 18 18 18 18 1 1 1 18 18 18 18 18 18 18 18 18 7 2 6 18 18 18 18 18 18 18 18 18 18 18 18 18 1 18 18 18 18 18 18 18 18 18 18 18 
18 18 18 18 1 1 1 1 2 1 1 1 18 18 18 18 18 18 18 18 18 18 7 17 6 18 18 18 18 18 18 18 18 18 18 18 18 18 1 1 1 18 18 18 18 18 18 18 18 18 
18 18 18 18 18 18 18 18 18 18 18 18 18 18 18 18 18 18 18 18 18 18 7 17 6 18 18 18 18 18 18 18 18 18 18 18 18 18 18 1 1 18 18 18 18 18 18 18 18 18 
18 18 18 18 18 18 18 18 18 18 18 18 18 18 18 18 18 18 18 18 18 18 7 17 6 18 18 18 18 18 18 18 18 18 18 18 18 18 18 1 1 1 18 18 18 18 18 18 18 18 
18 18 18 18 18 18 18 18 18 18 18 18 18 18 18 18 18 18 18 18 18 18 7 17 6 18 18 18 18 18 18 18 18 18 18 18 18 18 18 18 1 1 18 18 18 18 18 18 18 18 
18 18 18 18 18 18 18 18 18 18 18 18 18 18 18 18 18 18 18 18 18 18 14 3 15 18 18 18 18 18 18 18 18 18 18 18 18 18 18 18 1 1 18 18 18 18 18 18 18 18 
18 18 18 18 18 18 18 18 18 18 18 18 18 18 18 18 18 18 1 1 1 1 1 1 1 1 1 18 18 18 18 18 18 18 18 18 18 18 18 1 1 1 18 18 18 18 18 18 18 18 
18 18 18 18 18 18 20 20 17 17 18 18 18 18 18 18 18 1 1 1 1 1 1 1 1 1 1 1 18 18 18 18 18 18 18 18 18 18 18 1 1 1 1 18 18 18 18 18 18 18 
18 18 18 18 18 8 20 20 17 17 2 18 18 18 18 18 1 1 1 1 1 1 1 1 1 1 1 1 18 18 18 18 18 18 18 18 18 18 18 18 1 1 1 1 18 18 18 18 18 18 
18 18 18 18 32 29 29 31 13 10 10 12 18 18 18 18 18 1 1 1 1 1 1 1 1 1 1 1 1 18 18 18 18 18 18 18 18 18 18 18 18 18 18 1 18 18 18 18 18 18 
18 18 18 18 26 23 24 25 7 4 5 6 18 18 18 18 18 1 1 1 1 1 1 1 1 1 1 1 1 1 1 18 18 18 18 18 18 18 18 18 18 18 18 1 18 18 18 18 18 18 
18 18 18 18 26 28 27 25 7 9 8 6 18 18 18 18 18 1 1 1 1 1 1 1 1 1 1 1 1 1 1 18 18 18 18 18 18 18 18 18 18 18 18 1 18 18 18 18 18 18 
18 18 18 18 34 22 22 33 14 3 3 15 1 1 1 1 1 1 1 1 1 1 13 10 12 1 1 1 1 1 1 1 1 18 18 18 18 18 18 18 18 18 18 1 1 18 18 18 18 18 
18 18 18 18 30 30 32 31 16 16 13 12 18 18 18 18 18 1 1 1 1 1 7 16 6 1 1 1 1 1 1 1 1 1 1 1 13 10 12 18 18 18 18 1 1 18 18 18 18 18 
18 18 18 18 30 30 34 33 16 16 14 15 18 18 18 18 18 1 1 1 1 1 14 3 15 1 1 1 1 1 1 1 1 1 1 13 8 17 9 12 1 1 1 1 1 18 18 18 18 18 
18 18 18 18 18 18 18 18 18 18 18 18 18 18 18 18 18 1 1 1 1 1 1 1 1 1 1 1 1 1 1 1 1 1 1 7 17 16 17 6 1 1 1 1 1 18 18 18 18 18 
18 18 18 18 18 18 18 18 18 18 18 18 18 18 18 18 18 18 18 18 18 18 18 18 18 18 18 18 18 18 18 18 18 18 18 14 5 17 4 15 1 1 1 18 18 18 18 18 18 18 
18 18 18 18 18 18 18 18 18 18 18 18 18 18 18 18 18 18 18 18 18 18 18 18 18 18 18 18 18 18 18 18 18 18 18 18 14 3 15 18 18 18 18 18 18 18 18 18 18 18 
18 18 18 18 18 18 18 18 18 18 18 18 18 18 18 18 18 18 18 18 18 18 18 18 18 18 18 18 18 18 18 18 18 18 18 18 18 18 18 18 18 18 18 18 18 18 18 18 18 18 
18 18 18 18 18 18 18 18 18 18 18 18 18 18 18 18 18 18 18 18 18 18 18 18 18 18 18 18 18 18 18 18 18 18 18 18 18 18 18 18 18 18 18 18 18 18 18 18 18 18 
18 18 18 18 18 18 18 18 18 18 18 18 18 18 18 18 18 18 18 18 18 18 18 18 18 18 18 18 18 18 18 18 18 18 18 18 18 18 18 18 18 18 18 18 18 18 18 18 18 18 
18 18 18 18 18 18 18 18 18 18 18 18 18 18 18 18 18 18 18 18 18 18 18 18 18 18 18 18 18 18 18 18 18 18 18 18 18 18 18 18 18 18 18 18 18 18 18 18 18 18 
18 18 18 18 18 18 18 18 18 18 18 18 18 18 18 18 18 18 18 18 18 18 18 18 18 18 18 18 18 18 18 18 18 18 18 18 18 18 18 18 18 18 18 18 18 18 18 18 18 18 
